6 15
|-------------|
|FFF|.....|...|
|...........|.|
|FF...@|---...|
|..F...|....-.|
|-------------|